OO XOOXOXOOOOXOO OXXXXXXXX
OX XOXXOOOOXOOOOXOXOXOOOOO
OX      XOOOOXOO POOOXXXXX
OXPXX  XXOO OXOOXXOOOOOOOO
XOXXOO OXXX OOOOOOXOOOOOOO
OOOOOX OXOO OOxOXOOOXXXXXX
X   OOOOXXXXX OOOO   XOXXO
OOOXOO OOOO xOOOXOOXXXXXOX
OOOXOO  X   OOXOXXOOOOOOOO
OOOOOOXOO OOOOOOXOOOOXOXOO
OOOOOOXOOOOOOOOOXOOOOXOXOX
XXXOXXXXX   XXOXXXXXOXOXOX
